11111
10001
10201
10001
11111
