1111111111111111111111111111111
1000000000000000000000000000001
1001111111111111111111111111001
1001000000000000000000000001001
1001011111110111111111111101001
1001010000010100000000000101001
1001010111110101111111110101001
1001010100000101000000010101001
1001010101111101011111010101001
1001000101000001000001010001001
1001111101011111011111011111001
1000000001000001000001000000001
1111111111011101011101011111111
1000000000010001000100000000001
1001111111110111010111111111001
1001000000010000010000000001001
1001011111011111011111111101001
1001000001000000000000000101001
1001111100000002000000000101001
1000000000000000000000000000001
1111111111111111111111111111111
1000000000000000000000000000001
1000111111111111111111111111101
1000100000000000000000000000101
1111111111111111111111111111111